12 32 9
0 1 2 3 4 5 6 7 1 1 4 5 2 3 1 1 6 7 1 1 2 3 6 7 1 1 1 1 2 3 0 0
9 10 11 12 1 1 13 7 14 10 15 16 1 1 1 1 13 7 15 16 1 1 13 7 14 10 15 16 1 1 0 0
17 18 4 5 19 1 13 7 20 21 2 3 1 1 1 1 13 7 2 3 1 1 13 7 20 21 2 3 1 1 0 0
22 23 1 1 15 16 24 25 20 21 1 1 26 27 26 27 24 25 11 12 1 1 24 25 20 21 26 27 1 1 0 0
0 0 1 1 2 3 0 0 0 0 1 1 0 0 0 0 0 0 4 5 19 1 0 0 0 0 0 0 1 1 0 0
0 1 1 1 20 21 6 7 0 0 1 1 1 1 0 0 0 1 26 27 14 10 0 0 11 28 14 10 1 1 0 0
0 1 1 1 0 0 13 7 0 0 1 1 1 1 0 0 0 1 0 0 20 21 0 0 4 5 20 21 29 0 0 0
0 1 15 16 11 28 13 7 0 0 1 1 15 16 0 0 0 1 1 1 20 21 0 0 1 1 30 31 32 7 0 0
0 1 2 3 4 5 13 7 0 0 1 1 2 3 0 0 0 1 1 1 0 0 0 0 1 1 31 1 13 7 0 0
0 1 14 10 1 1 13 7 0 0 1 1 1 1 0 0 0 1 1 1 1 1 1 1 30 31 1 1 13 7 0 0
0 1 20 21 1 1 24 25 0 0 1 1 1 1 0 0 0 1 1 1 1 1 1 1 31 1 1 1 24 25 0 0
33 33 33 33 33 33 33 33 33 33 33 33 33 33 33 33 33 33 33 33 33 33 33 33 33 33 33 33 33 33 33 33