7 17
1 2 3 4 5 6 7 8 4 9 7 4 5 9 7 10 0 
12 3 9 4 13 7 14 14 4 2 8 4 13 15 8 10 0 
16 8 17 18 10 8 19 10 16 20 5 10 21 22 8 10 0 
23 9 21 4 10 8 9 10 23 19 13 10 3 24 25 10 0 
23 26 3 4 10 8 7 10 23 8 19 19 27 28 4 10 0 
29 30 31 32 33 31 31 33 29 31 31 31 34 31 32 33 0 
0 0 0 0 0 0 0 0 0 0 0 0 0 0 0 0 0 