12 48 27
0 0 1 2 3 4 5 6 7 8 9 9 10 11 12 13 1 2 1 2 14 2 1 2 9 5 5 5 14 2 5 5 1 2 1 2 5 5 1 2 5 5 14 2 15 16 17 18
0 0 20 21 22 23 24 25 26 26 27 27 28 29 30 31 20 21 32 33 34 35 20 21 36 37 32 33 34 35 38 39 20 21 32 33 40 35 41 37 32 33 34 35 42 43 44 45
0 0 46 47 27 27 48 24 49 27 27 49 28 29 50 51 46 20 52 53 53 54 46 20 55 56 52 53 53 54 57 58 46 59 52 53 53 54 55 56 52 53 53 54 60 61 44 45
0 0 26 22 27 27 22 23 24 25 36 62 28 29 20 63 64 65 53 53 53 53 64 65 66 21 67 53 68 69 30 31 26 22 67 53 53 53 66 21 53 53 53 53 20 21 44 45
0 0 27 49 27 27 49 49 70 24 55 71 28 29 72 20 73 56 74 75 76 69 77 56 46 20 78 53 79 79 50 51 27 80 78 53 81 53 46 20 74 75 76 69 46 47 44 45
0 0 36 65 27 27 0 0 0 0 0 0 28 29 42 82 66 21 42 43 68 83 66 21 64 65 84 53 79 79 20 63 27 80 84 53 85 53 64 65 53 53 79 79 26 22 0 86
0 0 55 87 27 27 88 66 88 89 88 66 28 29 60 61 46 20 60 61 79 79 46 59 55 56 90 53 79 79 46 20 27 91 90 53 90 53 55 56 74 92 79 79 27 27 93 94
0 0 0 0 95 27 41 65 26 22 20 21 28 29 20 21 64 62 79 0 66 96 26 22 26 26 0 0 66 96 64 65 27 27 20 21 20 21 66 21 20 21 97 26 27 27 98 99
0 0 88 89 49 49 55 87 27 27 46 47 28 29 46 59 55 56 88 89 46 47 27 27 27 27 88 89 46 59 55 56 27 27 46 47 46 47 46 47 46 47 49 49 49 49 100 101
0 0 26 22 0 0 0 0 102 49 103 104 28 29 103 104 103 103 103 104 103 104 49 49 49 49 103 104 103 104 103 103 49 49 103 104 103 104 103 104 103 104 0 0 0 0 0 105
0 0 49 49 88 66 88 66 0 0 0 0 0 0 0 0 0 0 0 0 0 0 0 0 0 0 0 0 0 0 0 0 0 0 0 0 0 0 0 0 0 0 0 0 0 0 0 106
79 79 79 79 79 79 79 79 79 79 79 79 79 79 79 79 79 79 79 79 79 79 79 79 79 79 79 79 79 79 79 79 79 79 79 79 79 79 79 79 79 79 79 79 79 79 79 79