12 48 21
0 0 1 2 3 3 3 4 1 5 6 6 6 6 6 6 6 6 6 6 6 6 6 6 6 6 6 6 6 6 6 6 6 6 6 6 6 6 6 6 6 6 6 6 6 6 0 0
0 0 8 9 10 10 11 12 8 13 14 14 14 14 14 14 8 15 8 15 14 14 14 14 14 14 14 14 16 17 14 14 14 14 14 14 14 14 14 14 14 14 8 15 8 15 0 0
0 0 10 10 10 18 19 20 10 18 14 14 14 14 14 14 21 22 21 22 14 14 14 14 14 14 14 14 23 24 14 14 14 14 14 14 14 14 14 14 25 26 10 22 10 8 0 0
0 0 10 10 10 27 28 29 30 18 14 14 14 14 16 17 31 32 33 34 16 17 14 14 14 14 14 14 35 36 8 15 8 15 8 15 8 15 37 26 38 38 11 12 10 10 0 0
0 0 10 10 10 21 39 40 21 21 14 14 14 14 41 24 42 14 14 43 23 44 14 14 14 14 14 14 45 22 10 8 10 8 21 22 21 8 38 38 38 38 46 47 10 10 38 48
0 0 10 10 11 12 49 36 0 0 14 14 33 34 0 0 14 14 14 14 9 9 16 17 16 17 8 15 50 51 21 21 10 10 0 0 52 53 28 54 55 12 8 8 21 21 38 56
0 0 10 18 46 57 45 8 0 0 58 14 14 43 8 22 59 60 14 61 10 10 23 62 23 24 21 22 63 64 0 0 10 10 65 28 66 52 67 68 46 47 10 10 0 0 38 69
0 0 10 10 49 36 8 10 8 70 37 26 37 26 11 12 28 54 40 29 30 10 9 9 35 36 0 0 71 54 16 17 10 10 31 32 33 34 52 72 8 8 21 21 28 54 0 0
0 0 21 73 74 22 10 21 10 21 38 38 38 38 46 47 67 40 67 40 21 21 21 73 74 8 65 28 67 40 23 62 10 18 42 14 14 43 66 52 21 21 0 0 39 75 0 0
0 0 0 0 76 0 11 12 11 77 0 0 0 0 0 0 0 0 0 0 16 17 0 0 8 18 14 14 0 0 78 78 21 21 14 14 16 17 0 0 0 0 8 8 8 9 0 0
0 0 0 0 79 80 46 81 46 47 22 22 65 28 65 28 65 28 22 22 41 24 65 28 21 21 59 60 65 28 0 0 0 0 59 60 41 24 65 28 65 28 21 21 21 21 0 0
38 38 38 38 38 38 38 38 38 38 38 38 38 38 38 38 38 38 38 38 38 38 38 38 38 38 38 38 38 38 38 38 38 38 38 38 38 38 38 38 38 38 38 38 38 38 38 38