7 25
1 2 3 4 2 5 5 5 6 6 5 5 5 5 7 5 5 5 5 5 5 6 6 1 0 
1 9 9 10 9 11 11 12 13 14 12 11 11 11 15 16 16 16 16 17 18 19 9 1 0 
1 9 19 20 21 11 22 23 24 25 26 12 12 16 27 9 9 21 28 29 30 31 9 32 0 
1 9 33 34 35 17 36 19 37 38 9 26 15 21 39 40 9 41 42 43 31 9 44 45 0 
1 21 46 19 19 47 47 48 49 49 50 21 34 51 49 26 9 24 52 53 21 35 54 1 0 
55 55 56 57 57 58 59 59 59 58 60 59 58 61 59 55 55 61 60 59 59 58 58 55 0 
0 0 0 0 0 0 0 0 0 0 0 0 0 0 0 0 0 0 0 0 0 0 0 0 0 