13 49
1 2 1 2 3 4 5 6 1 2 3 4 7 8 1 2 3 4 9 10 11 12 13 14 1 2 15 16 3 4 13 14 1 2 15 16 3 4 13 14 1 2 17 18 7 8 19 20 0 
22 23 24 25 3 4 22 23 22 23 3 4 26 26 22 23 3 4 27 28 24 25 22 23 29 30 31 32 3 4 33 34 29 30 31 32 3 4 33 34 29 30 17 35 26 26 36 20 0 
1 2 5 6 3 4 1 2 1 2 3 4 26 26 1 2 3 4 37 38 5 6 1 2 3 4 15 16 3 4 13 14 3 4 15 16 3 4 13 14 3 4 9 10 26 26 19 20 0 
39 40 41 41 41 41 42 43 44 45 3 4 26 26 22 23 3 4 46 47 22 23 22 23 3 4 22 23 3 4 22 23 3 4 22 23 3 4 48 49 3 4 46 47 26 26 50 51 0 
52 52 52 52 52 52 52 53 54 55 3 4 26 26 1 2 3 4 56 57 1 2 1 2 3 4 1 2 3 4 1 2 3 4 1 2 3 4 7 8 3 4 56 57 26 26 50 58 0 
17 35 22 23 29 30 59 60 53 61 41 41 39 40 41 41 41 41 42 43 44 45 22 23 3 4 22 23 3 4 22 23 3 4 22 23 3 4 24 25 3 4 62 63 64 65 50 66 0 
9 10 1 2 3 4 11 12 52 52 52 52 52 52 52 52 52 52 52 53 54 55 1 2 3 4 1 2 3 4 1 2 3 4 1 2 3 4 5 6 3 4 67 64 68 52 52 52 0 
46 47 22 23 3 4 22 23 48 49 3 4 24 25 3 4 24 25 59 60 53 54 44 45 3 4 22 23 3 4 22 23 3 4 22 23 3 4 22 23 3 4 69 68 70 71 36 20 0 
56 57 1 2 3 4 1 2 7 8 3 4 5 6 3 4 5 6 11 12 72 53 54 55 3 4 1 2 3 4 1 2 3 4 1 2 3 4 1 2 3 4 52 73 74 75 19 20 0 
39 40 39 40 76 77 39 40 39 40 76 77 39 40 76 77 39 40 39 40 39 40 53 61 76 77 39 40 76 77 39 40 76 77 39 40 76 77 39 40 76 77 39 40 39 40 78 20 0 
52 52 52 52 52 52 52 52 52 52 52 52 52 52 52 52 52 52 52 52 52 52 52 52 52 52 52 52 52 52 52 52 52 52 52 52 52 52 52 52 52 52 52 52 52 52 52 52 0 
73 73 73 73 73 73 73 73 73 73 73 73 73 73 73 73 73 73 73 73 73 73 73 73 73 73 73 73 73 73 73 73 73 73 73 73 73 73 73 73 73 73 73 73 73 73 73 73 0 
0 0 0 0 0 0 0 0 0 0 0 0 0 0 0 0 0 0 0 0 0 0 0 0 0 0 0 0 0 0 0 0 0 0 0 0 0 0 0 0 0 0 0 0 0 0 0 0 0 