7 25
1 2 3 4 5 6 7 8 2 9 10 2 11 12 10 13 2 9 14 15 12 10 16 17 0 
1 19 20 21 22 23 24 25 26 27 28 26 29 30 31 32 19 30 28 29 27 28 33 34 0 
1 23 20 35 36 37 24 38 29 39 40 29 26 41 42 25 20 41 43 26 44 45 19 46 0 
1 37 20 47 48 49 24 33 26 50 51 19 52 53 51 26 20 54 54 29 55 56 20 57 0 
1 48 35 37 20 19 24 19 52 48 19 20 20 48 19 52 20 19 19 19 19 35 35 58 0 
59 60 61 61 59 59 59 59 59 59 59 59 59 59 59 59 59 59 59 59 59 59 59 62 0 
0 0 0 0 0 0 0 0 0 0 0 0 0 0 0 0 0 0 0 0 0 0 0 0 0 