12 16 12
0 1 2 3 1 1 1 1 4 1 5 6 2 3 7 8
10 11 12 13 11 11 14 15 11 11 16 17 12 13 18 19
10 11 12 13 11 11 20 11 11 11 21 22 12 13 18 19
10 18 23 24 14 15 25 26 27 28 11 11 12 13 18 19
10 18 18 18 18 18 18 18 18 18 11 11 12 29 30 19
10 18 31 13 16 32 11 11 11 11 11 11 23 33 30 19
10 18 12 13 21 22 34 11 11 11 35 18 18 18 18 19
36 37 12 13 11 11 11 11 14 15 11 11 38 37 18 19
39 40 12 13 11 11 11 11 15 11 11 11 41 26 18 19
42 43 23 24 41 26 14 15 27 28 27 28 41 26 18 19
10 18 18 18 18 18 18 18 18 18 18 18 18 18 18 19 
44 45 45 45 45 45 45 45 45 45 45 45 45 45 45 46